R 1280 700
NO xpm/redbrick.xpm
SO xpm/grey.xpm
WE xpm/mossy.xpm
EA xpm/bluestone.xpm
S xpm/barrel.xpm
ST textures/sky_1.xpm
FT xpm/sand.xpm
F 184,113,39
C 51,198,227


111111111111111111111111
100000020001111111111111
100E00000000000000000001
110002000100111111111111
100011000100111111111111
100001100100111111111111
100100100101111111111111
110111100101111111111111
100000020001111111111111
111111111111111111111111

