R 1280 700
NO xpm/redbrick.xpm
SO xpm/grey.xpm
WE xpm/mossy.xpm
EA xpm/bluestone.xpm
S xpm/barrel.xpm
ST textures/sky_1.xpm
FT xpm/sand.xpm
F 184,113,39
C 51,198,227


1111111111111
1000000200011
100E000000001
1100020001001
1000110001001
1000011001001
1001001001011
1101111001011
1000000200011
1111111111111