
R         1980          890							defrgtyhntjymmhgfgdv 

            NO                  xpm/redbrick.xpm
    SO xpm/grey.xpm
                    WE xpm/mossy.xpm
FT                      xpm/sand.xpm            
EA xpm/bluestone.xpm  
          
    S xpm/barrel.xpm
    F 184,255,25
C               51,255,227







        1111111111111111111111111
        1000000000110000000000001
        1011000001110000002000001
        1001000000000000000000001
111111111011000001110000000000001
100000000011000001110111101111111
11110111111111011100000010021
111101111111110111010100100001
110000001101010111000000100101
10002000000000001100000010011
100000000000000011010100100101
11000001110101011111011110N0111
11110111 1000101 101111010001
11111111 1111111 111111111111

